static char JIANDAN_DITU[
    19
][
    20
] = {
    "###################",
    "#.........#...G...#",
    "#.###.#.#.#.#.###.#",
    "#P....G...........#",
    "#.#.#.#.###.#.#.#.#",
    "#.....#.....#.....#",
    "#####.# ### #.#####",
    "    #.#     #.#    ",
    "#####.# ### #.#####",
    "#.........#.......#",
    "#.###.#.#.#.#.###.#",
    "#...#.G.......#...#",
    "###.#.#.###.#.#.###",
    "#.....#.....#.....#",
    "#.#########.#####.#",
    "#..............G..#",
    "###################"
};

// 高级地图数据  
static char GAOJI_DITU[
    23
][
    37
]= {
    "####################################",
    "#............##............##......#",
    "#.####.#####.##.#####.####.##.###.#",
    "#O#  # #   #  #  #   #  # #   #  #O#",
    "#.#  # # # ## ## ## # #  # ## #  #.#",
    "#.#  #   #    #     #  #     #  #.#",
    "#O#  ####### # ######  # ##### #O#  ",
    "#.####.#..........#..........#.####.#",
    "#......#...G......#......G...#......#",
    "#.####.#..........#..........#.####.#",
    "#O#  # ##### ###### ###### ##### #O#",
    "#.#  # #       P        #      # #.#",
    "#.#  # # ## ## ## ## ## ## ## # #.#",
    "#O#  # # #  #  #  #  #  #  # # #O#  ",
    "#.####.###.##.##.##.##.##.###.####.#",
    "#..........................#.......#",
    "#####.####.##.######.##.####.#####  ",
    "#   #.#    #  #    #  #    #.#   #  ",
    "#   #.# ####  # ####  #### #.#   #  ",
    "#   #.# #     #    #     # #.#   #  ",
    "#   #.# # ############## # #.#   #  ",
    "#     .# #              # #.      # ",
    "####################################"
};